                                                                                                                                                    
                                                                                                                                                    
                                                                                                                                                    
                                                                                                                                                    
                                                                                                                                                    
                                                                                                                            0                       
           #######                                                                                                         000        ##############
         ###########                                                 ######                                       ##################################
       ##############                                              ###########                               #######################################
     #################                                            ###############                      #############################################
   ####################                                          #################                ##################################################
#########################                                      ######################        #######################################################
##########################                                    #########################  ###########################################################
####################################################################################################################################################
----------------------------------------------------------------------------------------------------------------------------------------------------
