                                                                                                                                     
																																	 
																																	 
																																	 
																																	 
#########                                                                                                                                       #####
################                                                                                                                         ############
#######################                                                                                                     #########################
##################################                                                                                 ##################################
#############################################                                                          ##############################################
######################################################                                      #########################################################
#####################################################################################################################################################