             
             
             
                     
                            ################                                                                                      
                     ############################                                                                                    
                 ###################################                                                                                              ###
             ##########################################                                                                                  ############
          ###############################################                                                                     #######################
##########################################################                                                           ################################
############################################################                                                #########################################
#####################################################################################################################################################