                                                                                                                                                    
                                                                                                                                                    
                                                                                                                                                    
                                                                                                                                                    
                                                                                                                                                    
                                                                                                                                                    
                            ################                                                                                                        
                     ############################                                                                                                   
                 ###################################                                                                              0               ##
             ##########################################                                                                          000     ###########
          ###############################################                                                                     ######################
##########################################################                                                           ###############################
############################################################                                                ########################################
####################################################################################################################################################
----------------------------------------------------------------------------------------------------------------------------------------------------