                                             
                                             
                                             
                                             
                                                       ##################         
                                            ######################################          
                                    ##############################################################        
                              #################################################################################
                     ####################################################################################################        
              ###################################################################################################################
         ################################################################################################################################### 
#####################################################################################################################################################   