                                              
                                              
                                                                                                      
                                              ######
                                           ############                                
                                         #################                                              
           ######                       #####################                       ######                     ###############
         ##########                   ##########################                  ##########                 ###################
       ##############                ###############################            ##############             #######################
     ###################           ###################################         ##################         ###########################
   #######################      #######################################       ######################     ###############################
#####################################################################################################################################################