                              
                              
                              
                              ###### 
                             ########  
                            ##########                                                                                         ######################
                           ############                                                                              ################################
                          ##############                                                                #############################################
                       ##################                                                     #######################################################
                    ###############################################                   ###############################################################
                ####################################################            #####################################################################
#####################################################################################################################################################